###############
#P            #
#             #
#             #
#             #
#   X         #
#       O     #
#             #
###############
