###############
#             #
#             #
#   o         #
#             #
#             #
#      o###################
#            P            #
###########################
