###############
#             #
#             #
#   O    X    #
#             #
#       X     #  ###
#       ##### ####O########
#                        P#
############# #### ########
           #  #### #
           #       #
	   #	   #
           #########