###############
#             #
#             #
#   OO   X X  #
#             #
#       O  X  #
# X     ###################
#                       PO#
###########################
