##### #########
#             
#             
#   OO   X X  
              
#       O  X  
#       ########### ##X####
#O                       P#
### ############X##########
#    #         # #
#  O #
######