##########
#        #
#   P    #
#   O    #
#        #
# X      #
#        #
#        #
#        #
##########