#########
#O      #
#   X   #
#   P   #
#########
