################
#              #
#     P        #
#              #
#        X     #
#              #
#              #
#              #
#             O#
################